###############################
#.............................#
###.############.##############
#.............................#
###..######################.###
# .#.............#.....#......#
#...##.########....#...#....###
#...............#..#..........#
###############################